der Aufzug - the lift, elevator
das Bad - the bath
das Badetuch - the bath towel
der Balkon - the balcony
sich beklagen - to complain
sich beschweren - to complain (about something)
best(a)tigen - to confirm, to certify
das Bettzeug - the bedding
die Decke - the cover
das Doppelzimmer - the double room
das Einzelzimmer - the single room
der Empfang - the reception, recipience, arrival
der Fahrstuhl - the elevator
das Familienzimmer - the Family room
frei - free
der Gang - the corridor
das Gasthaus - the inn
die Halbpension - the half board
das Handtuch - the towel
das Hotel - the hotel
inbegriffen - included
inklusive - inclusive
kaputt - broken
das Kopfkissen - the pillow
die Pension - the retirement
die Rechnung - the bill
reservieren - to reserve
die Reservierung - the reservation
das Restaurant - the restaurant
der Schl(u)ssel - the key
schmutzig - dirty
die Seife - the soap
der Speisesaal - the dining hall
teuer - expensive
(u)bernachten - to stay over night
die (U)bernachtung - the overnight stay
die Unterkunft - the accommodation
die Vollpension - the Full Board
das WC - the toilet/bathroom, water closet
die Zahnb(u)rste - the toothbrush
die Zahnpasta - the tooth paste
das Zimmer - the room
