die Achterbahn - the roller coaster
der Baum - the tree
besuchen - to visit
beten - to pray
erlauben - to allow
der Fasching - the carnival; Mardi Gras
fasten - to fast
feiern - to celebrate
der Feiertag - the public holiday
das Fest - the celebration
das Feuerwerk - the firework
die Gans - the goose
der Geburtstag - the birthday
das Geschenk - the gift
der Heiligabend - the Christmas Eve
heutzutage - nowadays
die Hochzeit - the wedding
das Kost(u)m - the suit (for women), costume
mitmachen - to participate
das Oktoberfest - the Oktoberfest
das Ostern - the Easter
die Pute - the turkey
der Rhein - the Rhine
das Riesenrad - the ferris wheel
der Sekt - the champagne
das Silvester - the New Year's Eve
stattfinden - to take place
suchen - to search
die Tradition - the tradition
typisch - typical
der Umzug - the move; parade
verkleidet - dressed-up, disguised
das Weihnachten - the Christmas
