der Anorak - the winter coat
der Anzug - the suit
der Badeanzug - the swimming suit
die Badehose - the swimming trunks
die Baumwolle - the cotton
die Bluse - the blouse
die Farbe - the color
gestreift - striped
die Gr(o)(ss)e - the size
die Handschuhe - the gloves
das Hemd - the shirt
die Hose - the trousers
der Hut - the hat
die Jacke - the jacket
die Jeans - the pair of jeans
kariert - checked
das Kleid - the dress
die Kleider - the clothes
die Krawatte - the tie
aus Leder - made of leather
der Mantel - the coat
die M(u)tze - the wooly hat, cap
aus Plastik - from plastic
der Pullover - the sweater
der Regenmantel - the raincoat
der Rock - the skirt
die Sandalen - the sandals
der Schlafanzug - the pyjamas
der Mantel - the coat
Schuhe - shoes
die Seide - the silk
die Shorts - the shorts (clothing)
die Socken - the socks
die Strumpfhose - the (pair of) tights
das TShirt - the tshirt
aus Wolle - from wool
die Wolljacke - the wool jacket