Afrika - Africa
Amerika - America
das Ausland - the abroad
ins Ausland fahren - to go abroad
Australien - Australia
Belgien - Belgium
Deutschland - Germany
England - England
Europa - Europe
Frankreich - France
Griechenland - Greece
Gro(ss)britannien - Great Britain
Holland - Holland
Irland - Ireland
Italien - Italy
(O)sterreich - Austria
Portugal - Portugal
Schottland - Scotland
die Schweiz - the Switzerland
Spanien - Spain
die T(u)rkei - the Turkey
die USA - the USA
die Vereinigten Staaten - the United States
Wales - Wales
die Alpen - the Alps
der Kanal - the Channel
K(o)ln - Cologne
die K(u)ste - the coast
die Landschaft - the countryside, landscape
das Meer - the sea
das Mittelmeer - the Mediterranean
M(u)nchen - Munich
die Nordsee - the North Sea
die Ostsee - the Baltic Sea
der Rhein - the Rhine
der See - the lake
die See - the sea
der Strand - the beach
Wien - Vienna
