die Abgase - fumes
das Altpapier - used paper
abschalten - to turn off
bauen - to build
benutzen - to use, consult
die Dose - can
eigentlich - actually
die Energie - energy
die Energiesparlampe - economy bulb
das Ergebnis - the result
fallen lassen - to drop
FCKWs - CFCs
die Flasche - bottle
die Gefahr - danger
hassen - to hate
die Hauptverkehrszeit - rush hour
die Heizung - heating
herunterdrehen - to turn down
in letzter Zeit - recently
der Kaugummi - chewing gum
der L(a)rm - noise
der Lastwagen - the truck
leer - empty
l(o)sen - to remove, solve
die Luft - air
der M(u)ll - refuse, rubbish
der Nachbar - neighbour
die Nachteile - disadvantages
neulich - recently
obdachlos - homeless
(o)ffentlich - public, publicly, in public
(o)ffentliche Verkehrsmittel - public transport
das Plastik - plastic
das Problem - problem
recyceln - to recycle
das Recycling - recycling, recycling container
sch(u)tzen - to protect
die Solarenergie - solar energy
sparen - to save (money)
die Spraydose - aerosol (can)
der Stau - accumulation, pile-up; traffic jam
stecken - put, stick
trennen - to separate, to detach
die T(u)te - bag
(u)berall - everywhere
(u)berbev(o)lkert - overpopulated
die Umfrage - The survey
die Umwelt - the environment
umweltfeindlich - environmentally unfriendly
umweltfreundlich - eco-friendly
der Umweltschutz - environmental protection
unterst(u)tzen - to support
verbessern - to improve
verderben - to spoil
der Verkehr - 1. traffic, 2. contact, intercourse
verschwenden - to waste
die Vorteile - advantages
wegwerfen - to throw away
die Welt - world
