der Aufschnitt - the cold cuts
das belegte Br(o)tchen - the filled roll
das Bonbon - the candy, sweet
das Butterbrot - the sandwich
der Bratensaft - the gravy
die Bratkartoffeln - the fried potatoes
die Bratwurst - the bratwurst
der Braten - the a roast
das Brot - the bread
das Br(o)tchen - the bread roll
die Butter - the butter
die Currywurst - the curried sausage
das Ei - the egg
der Eintopf - the stew
das Eis - the ice, ice cream
der Essig - the vinegar
der Fisch - the fish
das Fleisch - the meat
die Forelle - the trout
die Haferflocken - the rolled oats (porridge)
das H(a)hnchen - the chicken [gastr.]
der Hamburger - the hamburger
der Joghurt - the yogurt
das Kalbfleisch - the veal
der K(a)se - the cheese
der Keks - the cookie
der Kn(o)del - the dumpling
der Kopfsalat - the lettuce
der Kuchen - the cake
der Lachs - the salmon
das Lamm - the lamb
die Marmelade - the jam
die Meeresfr(u)chte - the seafood
die M(o)hre - the carrot
die Nudeln - the pasta
das (O)l - the oil
das Omelett - the omelet
der Pfeffer - the black pepper, chili/hot pepper
die Pizza - the pizza
die Pommes (Frites) - the chips
die Praline - the filled chocolate (in a box of chocolates)
der Reis - the rice
das Rindfleisch - the beef
die Sahne - the cream
das Salz - the salt
die Salzkartoffeln - the boiled potatoes
das Sauerkraut - the sauerkraut
der Schinken - the ham
die Schokolade - the chocolate
das Schweinefleisch - the pork
der Senf - the mustard
die Spaghetti - the spaghetti
die Spezialit(a)t - the speciality
das Spiegelei - the fried egg
das Steak - the steak
die Suppe - the soup
die S(u)ssigkeit - the candy
der Toast - the toast
die Torte - the cake
die Vanille - the vanilla
das Wiener Schnitzel - the veal escalope
die Wurst - the sausage
der Zucker - the sugar
