(sich) am(u)sieren - to enjoy (o.s)
anrufen - to call
der Ausflug - outing
ausgehen - to go out
begleiten - to accompany
besuchen - to visit
das Buch - book
der Computer - the computer
die Disko - disco
einkaufen - to shop
fernsehen - to watch tv
der Film - film
das Fitnesszentrum - fitness centre
fotografieren - to shoot, to take a photo/picture
die Freizeit - spare time
gefallen (+dat) - to please
gewinnen - to win
herumlaufen - to run/go around
h(o)ren - to hear
das Interesse - interest
die Karten - cards
das Kino - cinema
das Konzert - concert
lesen - to read
die Lust - pleasure
die Mannschaft - team
das Mitglied - member
die Musik - music
programmieren - IT, to programme
quatschen - to blab, to blather, to talk nonsense
der Roman - novel
sammeln - to collect
der Spa√ü - fun
spielen - to play
das Spiel - game
das Theaterst(u)ck - (theatrical) play
treffen - to meet
(u)ben - to practise
(sich) unterhalten - to talk
das Unternehmen- company
der Verein - club
das Videospiel - video game
der Wettkampf - competition
die Zeitschrift - magazine
