der Abfall - the rubbish
der Abfalleimer - the trash can
(a)ndern - to change
anfangen - to start; to begin; to commence
die Arbeitslosigkeit - the unemployment
aufstellen - to deploy
bauen - to build
der Becher - the beaker, tumbler, cup
beschlie(ss)en - to conclude
daf(u)r - 1. for that, 2. in favour of
dagegen - on the other hand
drau√üen - outside
einf(u)hren - to bring in, import
die Einwegflasche - the one way bottle
entt(a)uschend - disappointing
genug - enough
hoffen auf - to hope for
die Idee - the idea
der Kunde - the customer
niemand - no one
organisieren - to organize
der Parkplatz - the parking area
pflanzen - to plant
der Preis - the price; prize
der Radweg - the cycle path
reinigen - to purify
sorgen f(u)r - to look after, take care of
der Stau - the accumulation, pile up; traffic jam
umweltbewusst - conscious of the environment
die Verantwortung - the responsibility
vergessen - to forget
die Verpackung - the packaging
verschieden - different
verschwenden - to waste
werden - to become
zumachen - to close
leben - to live (to be alive)