abh(a)ngig - dependent
die Ader - the artery
der Alkohol - the alcohol
der Alkoholismus - the alcoholism
die Allergie - the allergy
anfangen - to start; to begin; to commence
Angst haben - to be frightened
der Appetit - the appetite
atmen - to breathe
aufgeben - to give up
aufh(o)ren (mit) - to conclude
aus Neugier - out of curiosity
die Bewegung - the movement, flow
das Blut - the blood
brechen - to break
der Cannabis - the cannabis
die Droge - the drug; medicine
der Drogenh(a)ndler - the drug dealer
der Drogens(u)chtiger - the drug addict
einnehmen - to take (meds etc)
ekelhaft - disgusting
die Erfahrung - the (noun) experience
das Fett - the fat (noun)
(sich) f(u)hlen - to feel
gef(a)hrlich - dangerous
das Gehirn - the brain
der Geruch - the smell
der Geschmack - the taste
gesund - healthy
die Gesundheit - the health
sich gew(o)hnen an - to become accustomed to
die Gewohnheit - the habit
grillen - to broil; to barbecue
halten - to keep
das Herz - the heart
das Image - the image
der Imbiss - the snack
kaputt machen - to ruin
die Kohlenhydrate - the Carbohydrates
der K(o)rper - the body
k(o)rperlich -physical
k(o)stlich - delicious, delightful
krank - sick, ill
die Krankheit - the illness
der Krebs - the crab, cancer
sich k(u)mmern um - to care for
lebendig - alive, lively
die Lebensmittel - the groceries
die Leber - the liver
lecker - yummy
die Lunge - the lung
magers(u)chtig - anorexic
die Mahlzeit - the meal
das Medikament - the medicine
die Milchprodukte - the milk products
m(u)de - tired
die Nahrung - the nourishment
nerv(o)s - nervous
die (O)ffentlichkeit - the public
probieren - to try
rauchen - to smoke
der Raucherhusten - the smoker's cough
das Rauschgift - the narcotic
riechen - to smell
das Risiko - the risk
die Ruhe - the peace, calm
schaden - to damage
sch(a)dlich - damaging
scharf - sharp, spicy
schlimm - bad
schmecken - to taste
der Schmerz - the pain
sch(u)tzen - to protect
sniffen - to sniff
die Sorge - the worry
die Spritze - the syringe
sterben - to die
die Sucht - the addiction
süchtig - addicted
die Abh(a)ngigkeit - the dependency
der Tabak - the tobacco
die Therapie - therapy
tot - dead
töten - to kill
trainieren - to exercise, to practice, to work out
die (U)berdosis - the overdose
vegetarisch - vegetarian (adj)
die Vene - the vein
verboten - forbidden
sich verletzen - to get hurt
die Verletzung - the injury
vermeiden - to avoid
verschwenden - to waste
versuchen - to attempt
verursachen - to cause
die Werbung - the advertisement
die Zigarette - the cigarette
