die Alpen - the Alps
die Ansichtskarte - (picture) postcard
der Aufenthalt - stay, wait (noun)
der Ausflug - outing
baden - to bathe
das Bargeld - cash
Bedienung! - Waiter!
ber(u)hmt - famous
besichtigen - to visit, to inspect
bestimmt - definitely
bleiben - to stay
bestellen - to order
bezahlen - to pay
die Bootsfahrt - boat trip
die Brosch(u)re - brochure
dauern - to last
entscheiden - to decide
das Erlebnis - experience
fahren - to drive
die Ferien - holidays
fliegen - to fly
der Fremder - foreigner/ stranger
f(u)hren - to lead/guide
die Galerie - gallery
herumreisen - to travel around
die Insel - island
kulturell - cultural
das Personal - staff
rei(ss)en - to tear
die Rundfahrt - tour
sehenswert - worth seeing
die Sehensw√ºrdigkeiten - attractions
die Sitzung - session, meeting
der Stadtbummel - stroll through town
die Stadtrundfahrt - city tour
der Stadtteil - part of town
surfen - to surf
der Tourismus - tourism
der Tourist - tourist
(u)berall - everywhere
unabh(a)ngig - independent
der Urlaub - vacation
verbessern - to improve
verbringen - to spend (time)
vermeiden - to avoid
woanders - somewhere else
der Zweck - purpose
