in der N(a)he von - close to, near
auf dem Land - in the countryside
an der K(u)ste - at the coast
am Meer - by the sea
an der See - by the sea
in der Stadtmitte - in the town centre
nicht weit von - not far from
die Aussicht - the prospect, view
bieten - to offer
das Dorf - the village
der Einwohner - the resident
empfehlen - to recommend
entdecken - to discover
die Freizeitm(o)glichkeiten - the leisure opportunities
die Gegend - the area
die Gro(ss)stadt - the city
historisch - historical
die Industrie - the industry
industriell - industrial
die Landschaft - the countryside, landscape
liegen - to lie (down)
losgehen - to get going
die Menge - the quantity
modern - fashionable, modern
m(o)glich - possible
der Nachteil - the disadvantage
ruhig - quiet, peaceful
die Stadt - the town or city
am Stadtrand - on the edge of town
sauber - clean
schmutzig - dirty
der Verkehr - the 1. traffic, 2. contact, intercourse
im Vorort - in the suburb
der Vorteil - the benefit
80km entfernt - 80km away