die Badewanne - the bathtub
der Baum - the tree
das Bett - the bed
die Blume - the flower
der DVD Spieler - the dvd player
die Essecke - the eating area
das Etagenbett - the bunk bed
das Fenster - the window
der Fernseher - the television
der Herd - the stove
der Kleiderschrank - the wardrobe
die Klimaanlage - the air conditioning
die Kommode - the dresser
der K(u)hlschrank - the refrigerator
die Lampe - the lamp
das Leder - the leather
die Mauer - the wall
die Mikrowelle - the microwave
das M(o)bel - the (piece of) furniture
die Pflanze - the plant
der Poster - the poster
das Radio - the radio
der Rasen - the lawn
das Regal - the shelf
die Schublade - the drawer
der Sessel - the armchair
das Sofa - the sofa
der Spiegel - the mirror
die Sp(u)lmaschine - the dishwasher
die Stereoanlage - the stereo
der Stuhl - the chair
das Telefon - the phone
der Teppich - the carpet
der Tisch - the table
die T(u)r - the door
das Videoger(a)t - the video machine
die Vorh(a)nge - the drapes
die Wand - the wall
die Waschmaschine - the washing machine
der Wecker - the alarm
die Zentralheizung - the central heating
