echt - genuine
sehr - very
total - totally
wirklich - really
nicht sehr - not very
besonders - especially
ein bisschen - a bit
zu - to
angenehm - pleasant
anstrengend - tiring; exhausting
ausgezeichnet - excellent
bequem - comfortable
ber(u)hmt - famous
besser - better
bl(o)d - stupid
einfach - simple
fantastisch - fantastic
frisch - fresh
froh - glad
furchtbar - terrible
gef(a)hrlich - dangerous
gut - good
herrlich - magnificent; glorious; capital
hervorragend - outstanding
klasse - great, marvellous
kompliziert - complicated
langweilig - boring
leicht - light, easy
m(o)glich - possible
n(u)tzlich - useful
nutzlos - useless
praktisch - practical
prima - very good
schlecht - bad
schlimm - bad
schrecklich - horrible, frightful
schwach - weak
schwer - difficult, heavy
schwierig - difficult
der Spa(ss) - the fun
spitze - first class, great
toll - great
typisch - typical
wichtig - important
witzig - funny, witty, comical, facetious
wunderbar - wonderful
unm(o)glich - impossible