das Baby - the baby
der Bruder - the brother
der Cousin - the Cousin (m)
die Dame - the lady
das Einzelkind - the only child
die Eltern - the parents
der Erwachsene - the adult
die Frau - the woman/wife/Mrs.
das Fr(a)ulein - the miss
die Geschwister - the siblings
die Gro(ss)eltern - the Grandparents
die Gro(ss)mutter - the Grandmother
der Gro(ss)vater - the Grandfather
der Halbbruder - the Halfbrother
die Halbschwester - the Halfsister
der Herr - the man/Mr.
der Junge - the boy
das Kind - the child
die Cousine - the Cousin (f)
das M(a)dchen - the girl
der Mann - the man/husband
die Mutter/Mutti - the mother/mum
die Oma - the grandma
der Onkel - the uncle
der Opa - the Grandad
die Schwester - the sister
Schwieger... - in~law...
Stief... - step...
der Sohn - the son
die Tante - the aunt
die Tochter - the daughter
der Vater/Vati - the father/dad
der Verwandter - the relative (m.)
der Vetter - the cousin
der Zwilling - the twin
