aktiv - active
angeberisch - boastful
b(o)se - evil
doof - stupid, dumb
dumm - dumb
egoistisch - selfish
eifers(u)chtig - jealous
eingebildet - smug
ehrlich - honest
ernst - serious
faul - lazy
flei(ss)ig - hardworking
frech - cheeky, impudent
freundlich - friendly
geduldig - patient
gemein - mean
gl(u)cklich - happy
gro√üz(u)gig - generous
gut gelaunt - easyhilfsbereit - helpful
h(o)flich - polite
intelligent - intelligent
klug - clever
komisch - funny (1)
launisch - moody
laut - loud
leise - quiet
lieb - dear
lustig - funny (2)
mies - rotten
nett - nice
neugierig - curious
lebhaft - lively
sch(u)chtern - shy
selbstbewusst - selfsportlich - athletic
stolz - proud
streng - strict
sympathisch - likeable
unternehmungslustig - adventurous
