(a)rgern - to annoy
das Atomkraftwerk - nuclear power plant
aussterben - to die out
bald - soon
der Bauer - farmer
bedrohen - to threaten
das Benzin - the gas (petrol)
der Biom(u)ll - compost
bleifrei - unleaded
das D(u)ngemittel - fertilizer
der Gebrauch - use (noun)
genauso - in almost the same manner, just as well
der Hautkrebs - skin cancer
das Insektizid - insecticide
die Kohle - coal
das Kohlendioxid - carbon dioxide
das Kohlenmonoxid - carbon monoxide
der L(a)rm - noise
die Luft - air
das Naturschutzgebiet - conservation area
das (O)l - oil
organisch - organic
das Ozonloch - hole in the ozone layer
die Ozonschicht - ozone layer
das Pestizid - pesticide
das Plakat - poster
die Quelle - source
retten - to save
saurer Regen - acid rain (no article!)
schaden - to damage
schlimm - bad
schuld an etwas sein - to be guilty of
sicher - sure
der Sonnenbrand - sunburn
sp(a)t - late
der Strahl - beam, ray
das Thema - theme
das Tier - animal
verpesten - to pollute
die Verschmutzung - pollution
verursachen - to cause
verwenden - to use (v...)
wahrscheinlich - probably
