adoptiert - adopted
(a)hnlich - similar
allein - alone
der Alleinerziehender - single parent
das Altenheim - old peoples home
das Alter - age
arbeitslos - unemployed
der Arm - arm
die Armut - poverty
auf die Nerven gehen - to get on sb nerves
aufpassen - to keep an eye on, take care
der Ausl(a)nder - foreigner
aussetzen - to abandon, offer, stop
bed(u)rftig - in need
benachteiligen - to disadvantage, discriminate
ber(u)hmt - famous
deprimiert - depressed
die Diskriminierung - discrimination
der Einfluss - influence
die Eingliederung - incorporation
einsam - lonely
der Einwanderer - immigrant
die ethnischen Probleme - the racial issues
die Freundschaft - friendship
die Gastfreundschaft - hospitality
der Gastgeber - host, entertainer
geboren - born
gemein - mean
geschieden - separated
das Geschlecht - gender
die Gesellschaft - society, company, business
gestorben - dead
die Gewalt - violence
die Gleichheit - equality
die Hautfarbe - skin colour
herrschend - dominant
die Hochzeit - wedding
die Karriere - career
die Kriminalit(a)t - criminality
ledig - single
multikulturell - multicultural
die Not - need, hardship
obdachlos - homeless
die Rasse - race (ethnic), breed
der Rassismus - racism
schwatzen - to gossip
selbstst(a)ndig - independent
der soziale Wohnungsbau - social housing, council housing
spenden - to donate
die Staatsangeh(o)rigkeit - nationality
stehlen - to steal (+dative)
die Stelle - place
(sich) streiten - to quarrel
treu - 1. faithful, 2. loyal
ungerecht - unfair, unjust
der Vandalismus - vandalism
das Verbrechen - crime
verheiratet - married
verlobt - engaged
der Verlobter - fiance
die vorgefasste Meinung - preconceived idea
das Vorurteil - prejudice
die Wohlt(a)tigkeit - charity
zufrieden - satisfied
zusammenleben - to cohabit
