die Abteilung - the department
anbieten - to offer
das Angebot - the offer, supply
anprobieren - try on
die Apotheke - the pharmacy
die Armbanduhr - the wristwatch
der Aufzug - the lift, elevator
ausgeben - to spend (money)
ausverkauft - sold out
die Auswahl - the choice
die B(a)ckerei - the bakery
der Becher - the beaker, tumbler, cup
billig - cheap
die Brieftasche - the wallet
die Buchhandlung - the bookstore
das Buch - the book
die CD - the cd
die Drogerie - the toiletries and sundries store
das Einkaufszentrum - the shopping centre
das Erdgeschoss - the first floor
die Flasche - the bottle
ge(o)ffnet - open (pp)
das Gesch(a)ft - the business
das Geschenk - the gift
geschlossen - closed
gratis - gratis, costless
die Gr(o)(ss)e - the size
die Kamera - the camera
kaufen - to buy
das Kaufhaus - the department store
das Alter - the age
die Konditorei - the cake shop, confectioner's
der Korb - the basket
kostenlos - free of charge
die Kreditkarte - the credit card
die Metzgerei - the butcher shop
die Mode - the fashion
offen - open, openly
(o)ffnen - to open
die Packung - the package
das Parf(u)m - the perfume
das Portemonnaie - the purse
die Pralinen - the filled chocolates
die Puppe - the doll
der Rabatt - the discount, rebate
reduziert - reduced
der Regenschirm - the umbrella
die Schachtel - the cardboard box
der Schmuck - the jewellery
die Schreibwaren - the writing materials (pl.)
das Sonderangebot - the special offer
die Sonnenbrille - the sunglasses
der Stock - the floor (of building), stick
der Teddyb(a)r - the teddy bear
teuer - expensive
die T(u)te - the bag
umtauschen - to exchange
das Untergeschoss - the basement
wasserfest - waterproof