am Abend - in the/of an evening
ab und zu - now and then, from time to time
bald - soon
danach - afterwards
dann - then
endlich - finally
erst - first
erstens - firstly
gestern - yesterday
gew(o)hnlich - usual, usually
heute - today
heute Abend - tonight/this evening
immer - always
jeden Tag - every day
manchmal - sometimes
morgen - tomorrow
morgen Abend - tomorrow evening
morgen fr(u)h - tomorrow morning
morgens - in the morning
der Nachmittag - the afternoon
die Nacht - the night
nie - never
nochmal - again
noch einmal - once again
noch nicht - not yet
normalerweise - normally
nur - only
oft - often
sp(a)t - late
sp(a)ter - later
t(a)glich - daily
(u)bermorgen - day after tomorrow
(u)blich - usual, normal
vorgestern - day before yesterday
w(a)hrend - during, while
wieder - again
am Montag - on monday
Montags - on mondays, every monday