abfahren - to leave, depart
die Abfahrt - departure
ankommen - to arrive
die Ankunft - arrival
die Ausfahrt - exit (road)
die Auskunft - information
das Auto - car
die Autobahn - motorway
das Boot - boat
der Bus - bus
die Einbahnstra(ss)e - one way street
die Einfahrt - driveway
die F(a)hre - ferry
das Fahrrad - bicycle
der Flug - flight
der Flughafen - airport
das Flugzeug - airplane
das Gep(a)ck - luggage
die Klassenfahrt - educational trip (pl. +en)
der Leihwagen - the rental car
die Linie - line
mieten - to rent
das Motorrad - Motorbike
der Pass - passport
die Reise - trip
das Reiseb(u)ro - travel agent (office)
der Reisebus - coach
das Schiff - ship
st(o)ren - to disturb
die Stra(ss)enbahn - the tram
die U Bahn - subway; underground train system
die (U)berfahrt - crossing
der Zoll - duty, tariff
der Zug - train
der Zuschlag - surcharge
