bedeckt - overcast
es donnert und blitzt - there is thunder and lightning
es friert - it is freezing
frostig - frosty
hei(ss) - hot
kalt - cold
k(u)hl - cool
nass - wet
neblig - foggy, misty
es regnet - it's raining
es schneit - its snowing
sonnig - sunny
st(u)rmisch - stormy
trocken - dry
windig - windy
wolkig - cloudy
der Frost - the frost
das Gewitter - the thunder and lightning
der Grad - the degree
der Nebel - the fog
der Regen - the rain
der Schauer - the shower (weather)
der Schnee - the snow
die Sonne - the sun
der Sturm - the storm
die Temperatur - the temperature
das Wetter - the weather
der Wetterbericht - the weather forecast/report
die Wettervorhersage - the forecast
der Wind - the wind