die AG - the club
allerlei - all kinds of, all sorts of
das Arbeitspraktikum - the Work Experience
der Austausch - the exchange
benutzen - to use, consult
das Experiment - the experiment
das Fach - the school subject, division, case
ganz - completely
die Gesamtschule - the comprehensive school
gr(u)nden - to found
die Grundschule - the primary school
das Gymnasium - the grammar school
das Internat - the Boarding school
die Klassenarbeit - the test (pl. +en)
die Klassenfahrt - the educational trip (pl. +en)
der Klub - the Club
der Lehrer - the teacher
die Lehrerin - the teachers
lernen - to learn
die Mittagspause - the Lunch break
die Note - the grade
die Oberschule - the 6th form college
die Oberstufe - the 6th form
in Ordnung - in order
die Pause - the pause
das Pflichtfach - the compulsory subject
plaudern - to chat
die Realschule - the high school
schon - already
schreiben - to write
der Schuldirektor - the headmaster
die Schule - the school
der Sch(u)ler - the pupil/student (m/f)
die Sch(u)lerin - the pupils/students
der Schulhof - the playground
die Schulordnung - the school rules
das Semester - the semester
die Stunde - the hour
der Stundenplan - the schedule
der Unterricht - the lesson
verbieten - to forbid
die Versammlung - the meeting, congregation, assembly
das Wahlfach - the optional subject
w(a)hlen - to choose
die Zukunft - the future
